18 13
80 150
 1 1 1 1 1 1 1 1 1 1 1 1 1 1 1 1 1 1 
 1 0 2 2 2 2 1 1 1 0 0 0 0 0 0 0 0 1 
 1 0 0 0 0 0 0 0 0 0 0 0 0 0 0 0 0 1 
 1 0 0 1 1 1 1 1 0 0 0 0 0 0 0 0 0 1 
 1 0 0 0 0 0 0 1 0 0 0 0 1 0 0 0 0 1 
 1 0 0 0 0 0 0 0 0 0 0 0 1 0 0 0 0 1 
 1 0 0 0 0 0 0 1 0 0 0 1 1 0 0 0 0 1 
 1 0 0 0 0 0 0 0 0 0 0 0 0 0 0 0 0 1 
 1 0 0 0 0 0 0 1 0 0 0 0 0 0 0 0 0 1 
 1 0 0 0 0 0 0 0 0 0 0 0 0 0 0 0 0 1
 1 0 0 0 0 0 0 1 1 1 1 1 1 0 0 0 0 1
 1 0 0 0 0 0 0 0 0 0 0 0 0 0 0 0 0 1
 1 1 1 1 1 1 1 1 1 1 1 1 1 1 1 1 1 1 

